|--------------------------X--|
|   #              G     M    |
|   K                     M   |
|           |----|            |
|  G   M    D    |----     G  |
|           |  G    |         |
|  G        |-------|   M  M  |
|             M       M       |
|                             |
|   M                   G     |
|----|                        |
| S  D     |---|         S    |
|G   |-----|   D       M      |
| @ kD         |    G         |
|-E--|---------|--------------|