|-----------------------------|
|  K      G                   |
E@                            |
|           |----|    G   M   |
|           |    |-D--        |
|           | S  G  |         |
|           |-------|         X
|                             |
|                             |
|   G                         |
|                             |
|          |---|              |
|    |-----|   |       #   G  |
|    |         |              |
|----|---------|--------------|