|--------------------------X--|
|   #                G        |
|   K                         |
|G          |----|        M   |
|           |    |-D--        |
|           | S     |         |
|           |-------|         |
|                             |
|                             |
|   M                         |
|                       G     |
|          |---|              |
|    |-----|   |              |
| @  | G       D              |
|-E--|---------|--------------|