|--------------------------X--|
|   M        G                |
|   #                     M   |
|           |----|            |
|   G         G         G     |
|           |    |----        |
|           |-------|         |
|   K                         |
|                             |
|               M             |
|                             |
|         |---D|         S    |
E@   |----|    |   G          |
|    |   K  S  |              |
|----|---------|--------------|