|--------------------------X--|
|   #        G            M   |
|    M                        |
|           |-------|         |
|           |S   M  |-        |
|  G        | G      |        |
|           |------D-|        |
|                             |
|              M              |
|   G                         |
|                      G      |
|          |-D-|              |
|    |-----|   |              |
|    | G   S   | K      @     |
|----|---------|--------E-----|