|-----------------------------|
|   #           M             |
|   K                    G    |
|           |----|            |
| M          | M   |----      |
|           |       |         X
E@          |-------|         |
|   G      G                  |
|                             |
|                             |
|                       M     |
| S        |---|         S    |
| G  |-----|   |              |
|    |   G     | M            |
|----|---------|--------------|