|-----------------------------|
|   #           M             |
|   K                    G    |
|           |----|            |
|           | M    ----       |
|           |    M  |         |
E@          |-------|         |
|   G      G                  |
|                             |
|                             |
|                       M     |
| S        |---|         S    |
| G  |--D--|   |              |
|    |G  G  M  | M         K  |
|----|---------|-------------X|