|-----------------------------|
|   #  M           G          |
| M K                         |
|    M      |----|            |
|  G        D    |----     G  |
|           |       |        @E
|  G                          |
|                             |
|    |---|-------|            |
|    D      M  |        G     |
|    |   S     |   K          |
| S  | M   |-D-|         S    |
| M  |     | # |              |
|    |  M  | GG|    G         |
|-X--|-----|---|--------------|