|--------------------------X--|
|   #              G          |
|   K                         |
|           |----|            |
|  G        D    |----     G  |
E@          |  G    |         |
|  G        |-------|         |
|                             |
|                             |
|   M          M        G     |
|                             |
| S        |---|         S    |
|    |---D-| G |              |
|    | G  G    |    G         |
|----|---------|--------------|