|-----E--------------------X--|
|   # @            G          |
|   K                         |
|           |----|            |
|  G        D    |----     G  |
|           |  G    |         |
|  G        |-------|         |
|      M          M           |
|                             |
|   M        M          G     |
|                             |
| S        |---|    M    S    |
|    |---D-|   |              |
|    |  G G G  |    G         |
|----|---------|--------------|